**********************
**********************
**********"22%********
******"###,  -#%******
******!       B$******
******!       A$******
******!    a   $******
******!  ######+******
******!        $******
******!        $******
******+####  ##+******
******!/       $******
******(&&&&&&&&)******
**********************
**********************
**********************
