**********************
**********************
**********************
******"########%******
******!        $******
******!        $******
******!        $******
******!  ######+******
******!        $******
******!        $******
******+####  ##+******
******!        $******
******(&&&+  +&)******
***********11*********
**********************
**********************
