**********
*########*
*#/ a  b#*
*########*
**********
